$Entrance$
■■□■■■■■■■□□■■■
■□　□　　　　　　　　　　■
■□　　　□　　　　　　□　■
■□□□□□　　　　　　　　■
■　　　　　　　　　　　　　■
■　　　　　　　□□　□□　■
■　　■■■　　　　　　　　■
■　　■□■　　□□　□□　■
□　　■■■　　　　　　　　■
□　　　　　　　□□　□□　■
■　　　　　　　　　　　　　■
■■■■■□□■■■■■■■■

$B1A$
■■■■■■□□■■
■□□□　　　　　■
■　　　　　　　　■
■　　　　　　　□■
■□□　　　　　□■
■□□　　　　　　■
■□□　　　　　　■
■■■■■■■■■■
